NO ./images/mossy1680272822.xpm
SO ./images/colorstone1680272389.xpm
WE ./images/purplestone1680272158.xpm
EA ./images/redbrick1680272129.xpm

C 127,166,252
F 75,101,75

1111111111111111111111111
1000000000110000000000001
1011000001110000000000001
10010000000000000000000011111111
111111111011000001110000000000001
100000000011000001110111111111111
11110111111111011100000010001
11110111111111011101010010001
11000000110101011100000010001
10000000000000001100000010001
100000000000000011010100000001
11000001110101011111011110N0111
11110111111101011101111010001
11111111111111111111111111111