NO ./images/mossy1680272822.xpm
SO ./images/colorstone1680272389.xpm
WE ./images/purplestone1680272158.xpm
EA ./images/redbrick1680272129.xpm

C 130,106,75
F 139,137,137

1111111111111111111111111111111111
1000000000000000000000000000011111
100000000000000000000000000000001111
1000000000000000000000000000000000001
10000000000000000000000000000000000001
10000000000000000000000000000000000001
100000000000000000W0000000000000001111
100000000000000000000000000000000000001
100000000000000000000000000000000001111
100000000000000000000000000000000000001
1111111111111111111111111111111111111111111
